___________________
____####___________
__##__#############
_______###_________
____###____###_____
_____P_____________
___________________