___________________
____    ___________
__  __             
_______   _________
____   ____   _____
_____ _____________
_______________P___