|                  |
|__________________|
|___    ___________|
|_  __             |
|______   _________|
|___   ____   _____|
_____ ______________
|_______I______P___|